{
  "NIGHT": true,
  "SPAWN": [ 12, 3 ],
  "MAP": [
    "................O...............O........................",
    "...O.....######.........................#####O........O..",
    "......@@@@###@@@@@@...O.............########@@@@@@.......",
    "...@@@@@#######@@@@@@@.......O...#########@@@@@@@@@@@....",
    "..@@@@@....O.....@@@@@@@@......#########.......@@@@@@@...",
    ".@@@@@...,,,,,,,.....@@@@@.#########....O......O..@@@@@..",
    ".@@@@@..,,,,,,,,,,,...@@@@@######..........O........@@@@.",
    ".O@@@@...,,,,,,,..O..@@@@#######....O..............@@@@@.",
    "O.@@@@@...,,,,....################.......O.....O.@@@@@@@.",
    "...@@@@@@......#########################.......@@@@@@@...",
    "....@@@@@@@@@#############...###############@@@@@@@......",
    "......@@@@############.........################@@@....O..",
    "....O......#######............O......############........",
    "........................O................................"
  ]
}