{
  "NIGHT": true,
  "SPAWN": [ 19, 2 ],
  "MAP": [
    "............##################.............",
    "......############################.........",
    "....###########@@@@@@@@@@@##########.......",
    "..######@@@@@@@@@@@@@@@@@@@@@@#######......",
    ".#####@@@@@@@@@@@@@@@@@@@@@@@@@######......",
    "..#######@@@@@@@@@@@@@@@@@@@@######........",
    "....############@@@@@@@@#########..........",
    ".........#####################.............",
    ".............#############................."
  ]
}